14 11
11111111111
12000101011
10000110011
10000100011
10010101011
10000101111
10001000001
10000010011
11001001101
10110100011
10011110001
10011000001
10011000101
11111111111
7 5
