10 20
11111111111111111111
11021200222021212211
10202010221220110111
10122011022211000211
11202212000022212201
11210200022202002101
10101202220200000221
12001111201221221021
11203003202012000101
11111111111111111111
1 1
