11 22
11111111111111111111
10222120002002122221
12112121111112121121
12122000222112222101
12121121122112112121
12002221100112220201
12121121122112111121
12122001122222221121
12111121111112121121
13002022200222122001
11111111111111111111
1 1