11 16
1111111111111111
1311212001000011
1202100022020011
1022010120001221
1111120211020101
1110110100021201
1002021120200001
1121201001011001
1212011020201021
1010220100012101
1111111111111111
2 6
