12 18
111111111111111111
111000001000100001
100212110000010101
100113000001000001
100100101000021001
101111011013000011
110200000011000111
111000000111100111
101100000010120011
110100000000301011
100100101100000101
111111111111111111
5 14
