21 22
111111111111111111111
102222222212222222221
121112111212111211131
121112111212111211121
122222222222222222221
121112121111121211121
122222122212221222221
111112111212111211111
000012122222221210000
111112121111121211111
000012221000122210000
000012121000121210000
111112121111121211111
122222222312222222221
121112111212111211121
122212222212222212221
112212121111121212211
122222122212221222221
121111111212111111121
122222222222222222221
111111111111111111111
1 1