13 19
1111111111111111111
1300120121100102001
1101011000000011001
1000001000000000001
1000121200001200001
1100010000200000011
1010110001200000001
1100112100002000001
1000101210010020011
1100111120001010121
1211000001000000101
1000000000001021001
1111111111111111111
7 8
