13 16
1111111111111111
1320000111011001
1200221020010111
1110012012100101
1211221011010021
1222010001112111
1222122100202021
1222110202112021
1010000101102101
1112202000012221
1210222122111001
1000120210002211
1111111111111111
8 14
