7 20
11111111110111111111
10000000000000000001
11111111110000000001
00000000000000000000
10000111111111111111
10000000000000000021
11111111110111111111
28 26