10
-.-.-.-.-.-.B.-.-.-
BS.S.-.S.-.B.P.B.-.-
P.W.S.W.S.-.B.-.-.-
BS.S.-.S.-.G.-.-.-.B
-.-.-.-.-.-.-.-.B.P
B.-.-.-.-.S.-.-.-.B
P.B.-.-.S.W.S.-.-.-
B.-.-.-.G.S.-.-.-.-
-.-.B.-.-.-.G.-.-.-
A.B.P.B.-.-.G.G.-.-
