10
S.W.S.B.-.-.S.-.-.BS
-.S.B.P.B.S.W.GS.BS.P
-.-.-.B.-.-.S.W.S.BS
G.-.-.-.-.-.-.S.-.-
-.-.-.-.-.-.-.-.-.-
-.-.B.S.-.G.-.-.G.-
-.B.P.W.S.-.-.-.-.-
-.G.B.S.-.-.-.-.-.-
-.-.-.-.-.-.-.-.B.-
A.-.-.-.-.-.-.B.P.B
