10
-.B.P.B.-.-.-.S.-.G
B.P.B.-.G.-.S.W.S.-
BS.P.B.-.-.-.-.S.-.-
W.BGS.-.-.B.-.-.-.-.-
S.-.-.B.P.B.-.-.-.-
-.-.-.-.B.-.-.-.-.G
-.-.S.-.-.-.-.-.-.-
-.S.W.S.-.-.-.-.-.-
-.-.S.-.S.-.-.BG.-.-
A.S.W.S.W.S.B.P.B.-
