10
-.-.-.-.-.-.G.-.B.B
-.-.-.S.-.-.S.B.P.P
-.-.S.W.S.S.W.S.B.B
-.-.-.S.-.-.S.W.S.-
-.-.-.-.-.-.S.S.-.-
-.-.-.-.-.S.W.S.G.-
-.-.-.-.-.-.S.-.-.G
-.-.-.-.-.-.-.-.-.-
-.-.B.-.-.B.-.-.S.B
A.BG.P.B.B.P.B.S.W.P
