-.-.-.-.-.-.-.-.S.-
-.-.-.-.-.-.-.S.W.S
-.-.-.-.-.-.S.W.S.-
-.B.-.-.-.-.-.S.-.-
B.P.BG.-.-.-.-.-.-.S
-.B.G.G.-.-.-.-.S.W
-.-.-.G.S.G.-.B.G.S
-.-.-.S.W.S.B.P.B.-
-.-.B.-.S.-.-.B.-.G
A.B.P.B.-.-.-.G.-.-
