10
-.-.-.-.-.-.-.-.-.-
-.G.-.-.-.-.-.-.-.-
G.-.-.-.G.S.-.-.-.-
G.-.-.-.S.W.S.-.-.-
-.G.-.-.-.S.-.-.-.-
BG.-.-.-.-.S.-.-.B.-
P.B.-.S.S.W.S.B.P.B
B.-.S.W.S.S.-.B.B.-
-.-.-.S.S.-.B.P.B.-
A.-.-.S.W.S.-.B.-.-
