-.-.-.-.S.B.-.-.-.-
G.S.-.S.W.P.B.-.-.-
S.W.S.-.S.B.-.-.-.-
-.S.G.S.-.-.-.-.-.-
-.-.S.W.S.-.B.-.-.-
-.-.BG.S.-.B.P.B.-.-
-.BG.P.B.-.-.BG.-.-.-
-.-.B.-.-.-.-.-.-.G
-.-.-.-.-.-.-.-.-.S
A.-.-.-.-.-.-.-.S.W
