10
-.-.-.-.-.-.-.-.-.-
-.-.-.-.-.-.-.G.-.-
-.-.-.-.-.-.-.-.-.-
B.B.B.B.B.B.B.B.B.B
P.P.P.P.P.P.P.P.P.P
B.B.B.B.B.B.B.B.B.B
SB.P.B.-.-.-.-.-.-.-
W.SB.-.-.-.-.-.-.-.-
S.G.B.-.-.-.-.-.-.-
A.B.P.B.-.-.-.-.-.-