-.-.-.-.-.-.B.P.B.-
-.-.-.-.-.S.-.B.-.-
-.-.-.G.S.W.S.-.-.-
G.-.-.-.-.S.-.B.G.-
-.-.-.-.-.B.B.P.B.-
-.S.-.-.B.P.B.B.-.-
S.W.GS.-.-.B.-.-.-.-
W.S.G.-.-.-.-.-.-.-
S.-.G.-.G.-.-.-.-.-
A.G.-.-.-.-.-.-.-.-
