-.-.B.P.B.-.-.S.-.S
G.-.-.B.-.-.S.W.S.W
-.-.-.-.-.G.-.S.-.S
-.G.-.-.-.-.-.-.-.G
-.-.-.S.-.-.-.G.B.-
-.-.S.W.S.-.-.B.P.B
-.-.B.S.-.-.-.-.B.-
-.B.P.BGS.-.-.-.-.-.-
-.G.BS.W.S.G.-.-.-.-
A.-.-.S.-.-.G.-.-.-
