11 20
11111111111111111111
10000100000000100001
10110101111110101101
10100000000000000101
10101101100110110101
10000001000010000001
10101101100110110101
10100000000000000101
10110101111110101101
10000100000000100021
11111111111111111111
1 1