21 27
111111111111111111111111111
100000000000010000000000001
101111011111010111110111101
101100011111010111110111101
101111011111010111110111101
100000000000000000000000001
101111011011111110110111101
100000011000010000110000001
111111011111010111110111111
111111011000000000110111111
000001000011111110000100000
111111011000000000110011111
111111011011111110110111111
100000000000010000000000001
101111011111010111110111101
100010000000000000000110001
111011011011111110110110111
100000011000010000110000001
101111111111010111111111101
100000000000000000000000001
111111111111111111111111111
1 1