21 22
111111111111111111111
100000000010000000001
101110111010111011101
101110111010111011101
100000000000000000001
101110101111101011101
100000100010001000001
111110111010111011111
000010100000001010000
111110101111101011111
000010001000100010000
000010101000101010000
111110101111101011111
100000000010000000001
101110111010111011101
100010000010000010001
110010101111101010011
100000100010001000001
101111111010111111101
100000000000000000001
111111111111111111111
1 1