10 20 ->(rows,cols)
1111111111
1010000001
1010000001
1010000001
1000111111
1000001011
1000001011
1000001011
1011111011
1000001011
1001001011
1001000011
1001000001
1001011101
1001012001
1001010001
1001010001
1001010001
1000010001
1111111111
1 1
