11 20
11111111111111111111
10000100030000100001
10110101111110101101
10100000000100000101
10101101100110110101
13000031000010200001
10101100100110111101
10100001000000000101
10110101111110101101
10000100000000100001
11111111111111111111
1 1