5 00
11111111111111111111
10000000000000000031
10011110000001111001
10000003000000300021
11111111111111111111
1 1