5 20
11111111111111111111
10222222222222222231
12211112222221111221
12222222222222222221
11111111111111111111
1 1