11 00
11111111111111111111
10000100003000100001
10110101111110101101
10100000000110000101
10101101100110110101
13000031100110000301
10101101100110111101
10100001100000001101
10111101111110101101
10000000000000100021
11111111111111111111
1 1