21 27
111111111111111111111111111
102222222222212222222222221
121111211111212111112111121
121122211111212111112111121
121111211111212111112111121
122222222222222222222222221
121111211211111112112111121
122222211222212222112222221
111111211111212111112111111
111111211222222222112111111
000001222211111112222100000
111111211222222222112211111
111111211211111112112111111
122222222222212222222222221
121111211111212111112111121
122212222222222222222112221
111211211211111112112112111
122222211222212222112222221
121111111111212111111111121
122222222222232222222222231
111111111111111111111111111
1 1