18 09
1111111111111111111111111111
1000000000000110000000000001
1011110111110110111110111101
1010010100010110100010100101
1011113111110110111110111101
1000000000000000000000000031
1011110110111111110110111101
1000000110000110000110000001
1111110111110110111110111111
0000010100000000000010100000
1111113101111111111010111111
1000000001000000001000000001
1011110100000300000010111101
1000010100000010000010100001
1110010110111111110110100111
1000003100000010000010000001
1000000000000000000000000021
1111111111111111111111111111
1 1