10
-.-.-.-.-.-.-.-.G.-
-.S.-.-.-.-.-.-.-.-
S.W.S.G.-.-.-.-.-.-
-.S.-.-.-.-.-.-.-.-
-.G.GS.-.-.-.-.-.-.-
-.S.W.S.-.G.-.-.-.-
S.W.S.-.-.-.-.-.B.B
-.S.-.-.-.G.-.B.P.P
-.-.S.-.-.-.-.-.B.B
A.S.W.S.-.-.-.-.G.-