10
-.-.-.-.-.-.-.-.G.-
-.S.-.-.-.-.-.-.-.-
S.W.S.G.-.-.-.-.-.-
-.S.-.-.-.-.-.-.-.-
-.G.GS.-.-.-.-.-.-.-
-.S.W.S.-.G.-.-.-.-
S.W.S.-.-.-.-.-.-.B
-.S.-.-.-.G.-.-.B.P
-.-.S.-.-.-.-.-.-.B
A.S.W.S.-.-.-.-.G.-