10
G.G.-.-.B.P.B.-.-.G
-.-.-.-.G.BS.-.-.-.-
-.G.-.-.S.W.S.-.-.-
G.B.-.-.-.S.-.-.-.-
B.P.B.-.-.-.-.-.-.-
-.B.P.B.-.-.-.-.-.-
-.-.B.-.S.-.-.B.-.-
G.S.-.SG.W.S.B.P.B.-
S.W.S.-.S.-.-.B.-.-
A.S.-.-.-.-.-.-.-.G