10
S.B.P.B.-.-.-.-.-.-
W.S.B.-.G.-.G.-.-.-
S.BG.-.-.-.B.-.-.-.-
B.P.B.S.BG.P.B.-.-.-
-.B.S.W.S.B.G.-.-.-
-.-.-.S.-.-.-.-.-.-
-.-.-.-.-.-.-.G.B.-
-.-.-.-.S.-.-.B.P.B
-.-.-.S.W.S.B.P.B.-
A.-.-.-.S.-.-.B.-.-
