11 13
1111111111111
1101011101221
1010010000201
1100113000001
1000300101021
1200130011101
1101121201021
1101101113121
1100030002011
1001002000001
1111111111111
2 3
