11 15
111111111111111
130200212101001
101120200200201
101002100122001
120121002011011
110121202002011
101022122120211
100020201111221
100210000121101
122200022021001
111111111111111
4 7
