11 22
11111111111111111111
12222122222222122221
12112121111112121121
12122222222122222121
12121121122112112121
12222231222212222231
12121122122112111121
12122221222222222121
12112121111112121121
13222122222222122221
11111111111111111111
1 1