11 22
11111111111111111111
12222122222222122221
12112121111112121121
12122222222112222121
12121121122112112121
12222221122112222231
12121121122112111121
12122221122222221121
12111121111112121121
12222222222222122231
11111111111111111111
1 1