15 10
1111111111
1101011101
1020210001
1013301001
1000000011
1002011031
1010100111
1100000001
1001101001
1000002011
1000221101
1000010001
1011303001
1000200011
1111111111
7 2
