11 14
11111111111111
13211020012011
10001120200021
12111222102021
12011100122211
10210220010101
11002122202011
11221211200101
11002120000111
11002102210101
11111111111111
3 11
