10 18
111111111111111111
112202311011110201
121021211231202221
121121002130201101
101202020110112001
100010201010020001
101101012120031221
100112120011100221
100200121022010121
111111111111111111
5 15
