11 22
11111111111111111111
10222122223222122221
12112121111112121121
12122222222112222121
12121121122112112121
13222221122112222221
12121121122112111121
12122221122223221121
12111121111112121121
12222232222222122221
11111111111111111111
1 1