15 32
1111111111111111111111111111111
1022221222222222222222221222221
1211121211121111111211121222221
1212221212222221222222121222221
1222111212111121211112221112221
1112121212122222212212122312111
1222121112121111111212111212221
1211122222221000001222222211121
1222121111121111111212111212221
1112122212122221222212122212111
1222111212111121211112121112221
1222222212222221322222122222121
1222221211121111111211121211121
1222221222222222222212221222221
1111111111111111111111111111111
1 1