14 17
11111111111111111
13210001001222111
12111121022112121
12022121102002121
11110002112220201
12111000211220001
12000010121210211
11001200111110011
12222020001100211
10022021010002211
12220012002221221
12102211001121111
12210110201122021
11111111111111111
8 13
