13 19
1111111111111111111
1200001000100100011
1010001110000011001
1001030100100000001
1030000311110101001
1100001100010001001
1110000000001000101
1110000000000110011
1010100100010000001
1100000003011000001
1001310000100000101
1110000000100001001
1111111111111111111
1 2
