10 14
11111111111111
13021222002001
12101102111021
10101001220011
12210112001011
12102011102021
11000000220121
10011220111001
12100112200021
11111111111111
4 11
