15 14
11111111111111
13000000000001
10122001010011
10000110112011
10000010100001
11000100100001
11000000000011
11000010000001
10000011000111
11000010000101
10000001010001
11000000002101
11000010010111
10100121000001
11111111111111
5 2
