11 19
1111111111111111111
1322202021110212201
1220211210211011101
1102020102020112001
1210220012002120011
1102000200212221021
1020122100002222121
1012220100200101021
1011210212200122211
1111122100121001021
1111111111111111111
7 14
