14 10
1111111111
1101220111
1001210231
1210000021
1102002221
1100110101
1203000011
1212010011
1013202001
1121111201
1301122011
1013222201
1011022221
1111111111
3 6
