15 14
11111111111111
11101300010211
10200101000011
12212200200011
10002210200101
10002201232111
11102001110101
11021101020201
10222011200011
10210120020001
10220100000021
10001000211011
11210021000101
11201020002001
11111111111111
12 10
