13 12
111111111111
132010121201
112012010121
121002220021
120012002211
122000222121
102112002011
112002201121
102022211021
111012211111
110201200101
121011222121
111111111111
8 3
