11 16
1111111111111111
1300110001100001
1000002100110221
1110001000110001
1001000100020101
1011020011011101
1100120020001121
1000010002000001
1000010000000011
1100001111001021
1111111111111111
2 8
