7 29
1111111111111111111111111111
1022222222222222222222222221
1212222122221111111112122221
1212222122221222222212122221
1211111122221222222212122221
1322222222222222222222122231
1111111111111111111111111111
1 1