12 15
111111111111111
110100100030121
100022000020001
100112001123001
120001011011021
101112001101021
110203101002001
121100002220001
100000111000001
110211101000201
101221002102111
111111111111111
5 10
