11 19
1111111111111111111
1111001020000100101
1301021022000110311
1000111022022200201
1000000011000120201
1002200100010121211
1220001102011010001
1220000020013020001
1002001001010000001
1011020122000000101
1111111111111111111
1 9
