11 11
11111111111
13101010001
10100100101
10102220011
10202000001
11001100111
12210211011
12112000101
11200000101
10220002011
11111111111
4 5
