13 18
111111111111111111
130002222002110201
111222102022121001
100020120212202201
100101020220201111
111000000022000101
120101002202122001
102001020001000021
100012200002002001
121110000120000011
121200212012221101
101121200200000001
111111111111111111
4 2
