13 18
111111111111111111
110000130200003211
111100100112021011
101201000000000011
121112200002000001
122110021100100001
120201100001101001
100111110011010011
102011000112000201
120101102211010011
110000010210301211
110200010001000011
111111111111111111
10 6
