12 20
11111111111111111111
13202111021222111221
12120200022210020211
12220001201020022101
12022111000022001111
10210211100212021121
10220010100122212101
12012201010021122201
12221021021210012001
12210001211112121211
11110202002012210121
11111111111111111111
3 6
