18 29
1111111111111111111111111111
1022222222222112222222222221
1211112111112112111112111121
1210012100012112100012100121
1211112111112112111112111121
1222222222222222222222222231
1211112112111111112112111121
1222222112222112222112222221
1111112111112112111112111111
0000012122222222222212100000
1111112121111111111212111111
1222222221000000001222222221
1211112122222222222212111121
1222212122222212222212122221
1112212112111111112112122111
1222223122222212222212222221
1222222222222222222222222221
1111111111111111111111111111
1 1