11 15
111111111111111
131000011121001
100010000111101
100000101000001
100110110010101
100201010020101
100011001010001
100001101001011
110010002021021
110001000100011
111111111111111
7 4
