11 15
111111111111111
131000000000001
100111000002011
101001000000001
110000100001001
102110202100001
100010200021001
100100100001001
101220121100001
111110000000101
111111111111111
5 10
