10 20
11111111111111111111
13100011001220000011
10000112000021000201
12210100002010000011
11120200010022002011
10000020010021122211
10011112001002102021
11021210012000212001
11011021110010111221
11111111111111111111
2 3
