10 13
1111111111111
1321201001011
1102210201201
1200010102101
1120102002101
1200021221221
1022022100121
1202210022001
1011200220001
1111111111111
2 6
