11 22
11111111111111111111
10222122222222122221
12112121111112121121
12122222222212222121
12121121122212112121
12222221123212222221
12122321122212112321
12122221122222222221
12111121111112121121
12222222222222122221
11111111111111111111
1 1