17 28
1111111111111111111111111111
1000000000000110000000000001
1011110111110110111110111101
1000000000000000000000000001
1011110110111111110110111101
1011110110111111110110111101
1000000110000110000110000001
1111110000100000010000111111
1111110110100000210110111111
1111110110000000000110111111
1111110110111111110110111111
1111110110111111110110111111
1000000000000110000000000001
1011110111110110111110111101
1011111111110110111111111101
1000000000000000000000000001
1111111111111111111111111111
38 52